NO ./textures/nord.xpm
SO ./textures/sud.xpm
WE ./textures/west.xpm
EA ./textures/est.xpm
F 255,0,0
C 148,157,120
 
    
    
    
    
    
    
    
    
    111111111
111110001000111111
1000100N1111111
1111100110000001
    10000000001111
111111111111
