NO ./textures/testimg.xpm
SO ./path_to_the_south_texture
WE ./path_to_the_west_texture
EA ./path_to_the_east_texture
F 220,100,255
C 225,30,0
 
    
    
    
    
    
    
    
    
    111111111
111110001000111111
1000100W1111111
1111100110000001
    10000000001111
111111111111
